[850]
[]
[283]
[852, 94]
[851, 285]
[856, 857, 31]
[95, 858, 284]
[288, 10, 853, 854, 855]
[33, 3, 287, 286]
[0, 11, 859, 862, 863, 96, 865, 102]
[12, 34, 35, 36, 289, 290, 307, 309, 861, 866, 867, 100]
[1, 922, 924, 32, 291, 38, 39, 860, 101, 103, 869, 105, 870, 107, 872, 873, 111]
[2, 6, 923, 928, 301, 304, 305, 306, 310, 312, 317, 322, 323, 335, 864, 98, 868, 106, 875, 108, 876, 116, 118, 119]
[7, 8, 9, 20, 110, 115, 296, 302, 303, 316, 324, 325, 326, 327, 334, 349, 350, 351, 355, 904, 906, 913, 916, 917, 918, 919, 920, 930, 933, 937, 938, 939, 952, 970, 972, 1006, 1007, 1008]
[5, 19, 21, 1048, 1051, 28, 1052, 1053, 1055, 1056, 1066, 1068, 61, 62, 63, 99, 109, 117, 120, 318, 346, 347, 348, 356, 357, 871, 889, 890, 891, 905, 907, 909, 911, 912, 914, 950, 953, 954, 968, 969, 975, 976, 977, 979, 981, 982, 984]
[4, 1039, 1040, 1041, 18, 1045, 1046, 29, 30, 37, 1067, 58, 64, 85, 87, 187, 188, 189, 190, 191, 295, 298, 300, 311, 319, 321, 328, 329, 330, 332, 336, 352, 353, 361, 363, 908, 921, 929, 931, 932, 949, 951, 957, 971, 978, 980, 1005]
[13, 14, 23, 24, 25, 26, 27, 1047, 1054, 1058, 1060, 1061, 1069, 1070, 1071, 1072, 1073, 564, 566, 55, 56, 57, 567, 568, 60, 570, 571, 572, 573, 574, 575, 576, 1084, 86, 88, 90, 91, 93, 97, 112, 114, 175, 184, 185, 186, 192, 193, 194, 256, 258, 262, 263, 297, 299, 320, 333, 354, 359, 362, 874, 886, 895, 896, 897, 902, 910, 915, 934, 935, 955, 965, 966, 985, 986, 988, 990, 992, 993, 1003, 1009, 1010]
[17, 1042, 1044, 22, 1049, 1057, 1063, 40, 41, 554, 43, 1064, 45, 558, 559, 1065, 562, 1074, 1080, 59, 1087, 1090, 579, 581, 582, 72, 74, 78, 79, 80, 84, 89, 92, 104, 1693, 1694, 1695, 1700, 166, 168, 1705, 1706, 1707, 176, 1712, 1713, 1714, 1715, 181, 182, 1716, 1717, 1718, 1722, 1719, 1727, 1728, 1729, 259, 260, 261, 771, 775, 264, 777, 267, 271, 275, 276, 787, 789, 792, 292, 293, 308, 338, 339, 344, 358, 888, 899, 961, 962, 987, 989, 991, 997, 999, 1000]
[15, 42, 44, 52, 66, 67, 68, 70, 71, 73, 77, 81, 82, 83, 113, 122, 126, 130, 131, 132, 138, 167, 170, 172, 173, 179, 183, 195, 224, 225, 236, 237, 239, 241, 242, 243, 253, 254, 255, 265, 266, 268, 269, 270, 272, 274, 277, 281, 282, 313, 314, 315, 337, 360, 499, 500, 528, 531, 544, 545, 546, 549, 560, 561, 563, 569, 577, 580, 584, 780, 781, 782, 786, 794, 795, 803, 815, 816, 826, 827, 828, 830, 878, 881, 882, 892, 898, 900, 926, 958, 960, 967, 983, 998, 1001, 1002, 1004, 1015, 1017, 1018, 1020, 1033, 1034, 1035, 1050, 1059, 1076, 1085, 1088, 1089, 1091, 1092, 1663, 1664, 1665, 1675, 1676, 1678, 1679, 1688, 1702, 1704, 1720, 1724, 1725, 1731, 1738, 1740, 1744, 1746, 1748]
[47, 54, 65, 75, 125, 133, 136, 158, 159, 169, 171, 174, 177, 199, 201, 203, 204, 205, 206, 211, 213, 214, 215, 218, 219, 220, 223, 246, 247, 248, 249, 250, 252, 278, 279, 280, 340, 343, 367, 368, 369, 380, 381, 392, 394, 395, 399, 415, 416, 417, 501, 503, 507, 511, 517, 519, 520, 526, 530, 540, 548, 552, 555, 557, 578, 583, 585, 587, 588, 674, 675, 677, 709, 711, 713, 714, 719, 726, 728, 730, 731, 760, 761, 764, 769, 770, 779, 790, 796, 800, 802, 804, 805, 809, 812, 814, 817, 818, 819, 823, 824, 831, 832, 833, 844, 845, 880, 893, 903, 927, 940, 942, 943, 946, 948, 963, 964, 974, 1043, 1075, 1077, 1082, 1083, 1498, 1499, 1585, 1587, 1595, 1596, 1633, 1635, 1637, 1641, 1677, 1680, 1681, 1683, 1686, 1687, 1691, 1699, 1701, 1703, 1708, 1711, 1721, 1723, 1730, 1734, 1741, 1742, 1743, 1747, 1749, 1755]
[16, 69, 123, 127, 134, 137, 142, 144, 178, 196, 197, 200, 202, 207, 217, 227, 228, 233, 234, 235, 238, 244, 251, 273, 331, 341, 342, 379, 393, 411, 475, 479, 480, 502, 504, 505, 508, 510, 515, 518, 522, 523, 527, 532, 533, 553, 556, 598, 599, 604, 605, 610, 613, 614, 616, 620, 645, 647, 655, 656, 659, 660, 661, 662, 673, 710, 718, 724, 725, 740, 744, 749, 752, 753, 757, 758, 759, 762, 763, 768, 778, 785, 791, 793, 806, 807, 808, 810, 813, 825, 829, 834, 835, 836, 838, 839, 840, 841, 846, 848, 877, 887, 901, 925, 947, 956, 959, 1011, 1012, 1014, 1021, 1023, 1030, 1031, 1062, 1078, 1081, 1086, 1103, 1104, 1107, 1110, 1143, 1177, 1178, 1179, 1184, 1185, 1186, 1187, 1188, 1198, 1199, 1200, 1248, 1249, 1251, 1253, 1500, 1501, 1502, 1503, 1504, 1510, 1511, 1523, 1553, 1554, 1558, 1559, 1560, 1561, 1563, 1579, 1580, 1591, 1593, 1594, 1621, 1622, 1634, 1636, 1638, 1639, 1646, 1648, 1649, 1657, 1658, 1666, 1667, 1668, 1673, 1684, 1685, 1690, 1726, 1732, 1733, 1735, 1736, 1737, 1745, 1757, 1767]
