[1593]
[1258, 2339]
[1762, 2297, 2921, 238, 1332, 2361]
[2308, 642, 2344, 1225, 2128, 2135, 1755, 28]
[773, 399, 2833, 914, 404, 2717, 1715, 468, 2521, 602, 989, 745, 2676, 2933, 2426]
[1793, 1672, 1550, 1427, 2324, 275, 2968, 672, 545, 2081, 2336, 677, 2088, 1072, 827, 2937, 2753, 1731, 596, 2263, 1371, 990, 2143, 992, 2537, 1898, 877, 111, 2927, 2289, 1401, 1659]
[26, 540, 2084, 2604, 2637, 78, 2645, 1640, 2680, 2688, 1155, 2186, 2700, 1686, 2206, 1702, 184, 2241, 2255, 2276, 249, 775, 1288, 266, 2835, 797, 287, 305, 2368, 1857, 1354, 335, 1875, 2901, 2400, 357, 879, 1910, 385, 2447, 1941, 1444, 423, 441, 1477, 2509, 2520, 2524, 505, 2558]
[2563, 523, 2060, 13, 1552, 528, 2582, 539, 1584, 2614, 56, 2104, 572, 2112, 1606, 2631, 584, 1613, 1623, 94, 103, 1131, 116, 2684, 2173, 2686, 129, 2694, 2696, 1167, 1679, 657, 2196, 2198, 153, 666, 1691, 2215, 2229, 1718, 2745, 2746, 2242, 706, 1729, 1733, 2765, 2767, 2772, 219, 2784, 227, 1252, 2811, 763, 2816, 263, 268, 2832, 2838, 2327, 283, 1325, 823, 315, 317, 2877, 2879, 2371, 1860, 1865, 841, 1363, 345, 2396, 2398, 2403, 869, 2408, 363, 1390, 2416, 880, 2926, 2931, 2421, 1913, 892, 1403, 1914, 2438, 1934, 401, 2449, 1430, 409, 1436, 2462, 928, 930, 1442, 2986, 1451, 426, 437, 1466, 2491, 1985, 968, 1482, 1483, 2507, 2002, 2005, 1494, 985, 1000, 1013, 2555]
[2053, 9, 2064, 35, 2109, 2110, 2114, 2122, 81, 86, 2142, 105, 2155, 108, 2167, 125, 138, 142, 2192, 150, 168, 177, 178, 2227, 210, 228, 2280, 240, 244, 255, 257, 276, 278, 2340, 2358, 318, 323, 350, 2402, 2405, 368, 2417, 2419, 2428, 2430, 2444, 2450, 402, 405, 406, 2461, 2467, 2470, 424, 2492, 2504, 2518, 2530, 490, 2546, 2572, 527, 535, 541, 550, 2599, 2621, 580, 581, 2628, 585, 2643, 2646, 607, 627, 2678, 2689, 643, 645, 2695, 2697, 648, 2708, 2716, 669, 681, 2732, 685, 688, 2740, 2748, 710, 2761, 2764, 2773, 2782, 743, 2797, 2798, 2810, 2829, 788, 2845, 799, 801, 2852, 813, 817, 818, 2867, 822, 2870, 2874, 2876, 2885, 838, 846, 2910, 2918, 870, 2923, 2928, 2930, 886, 2938, 2943, 2949, 915, 934, 935, 2991, 960, 964, 966, 972, 993, 1005, 1016, 1034, 1048, 1064, 1073, 1083, 1098, 1119, 1125, 1126, 1135, 1144, 1163, 1168, 1172, 1204, 1221, 1230, 1232, 1237, 1275, 1303, 1304, 1328, 1344, 1350, 1374, 1379, 1380, 1382, 1394, 1399, 1404, 1428, 1431, 1446, 1456, 1475, 1481, 1485, 1489, 1532, 1585, 1596, 1601, 1627, 1652, 1657, 1658, 1683, 1690, 1700, 1705, 1714, 1732, 1777, 1796, 1798, 1801, 1803, 1805, 1806, 1839, 1841, 1854, 1859, 1902, 1908, 1928, 1936, 1951, 1959, 1999, 2008, 2009, 2027, 2030]
[2, 6, 7, 2063, 22, 2071, 2076, 30, 2082, 38, 2086, 2090, 42, 2093, 2095, 54, 55, 2106, 65, 66, 84, 2140, 96, 98, 2148, 2151, 2153, 2157, 112, 2165, 124, 132, 2183, 140, 2189, 141, 2195, 2197, 152, 2201, 2202, 2205, 2211, 2220, 173, 180, 187, 2235, 191, 2243, 200, 2248, 203, 209, 2266, 2272, 236, 2287, 2286, 2290, 245, 2303, 2307, 2309, 2316, 272, 273, 277, 288, 2348, 2353, 2356, 312, 313, 316, 319, 320, 325, 2374, 339, 2388, 2391, 2394, 346, 353, 362, 364, 2413, 365, 2414, 370, 369, 2420, 2423, 2431, 395, 2445, 398, 2452, 407, 412, 417, 2466, 2475, 2476, 2474, 430, 2479, 432, 2483, 438, 2487, 2494, 2496, 449, 2499, 2500, 2501, 2502, 454, 457, 2508, 462, 2512, 465, 2515, 472, 489, 492, 504, 2556, 512, 2561, 514, 2562, 2567, 522, 2577, 2576, 2579, 2580, 2584, 542, 2594, 2603, 555, 2606, 2608, 562, 563, 2610, 570, 576, 2624, 578, 592, 2642, 2644, 599, 601, 2658, 611, 614, 2663, 615, 617, 618, 2666, 2669, 2673, 630, 635, 2691, 647, 2693, 2699, 2711, 2713, 665, 2718, 683, 686, 2739, 696, 697, 2751, 714, 724, 729, 2778, 2781, 2788, 740, 2794, 749, 753, 756, 758, 764, 2812, 2814, 2815, 2819, 771, 2830, 2844, 803, 2854, 2857, 2864, 821, 830, 835, 837, 845, 2894, 2898, 859, 2909, 2914, 874, 887, 891, 894, 898, 901, 2958, 2960, 2963, 2965, 921, 926, 2979, 2984, 939, 940, 2988, 2999, 953, 963, 979, 982, 986, 1015, 1021, 1028, 1035, 1051, 1062, 1079, 1082, 1086, 1091, 1095, 1101, 1112, 1114, 1121, 1132, 1133, 1141, 1150, 1157, 1160, 1161, 1162, 1169, 1173, 1177, 641, 1181, 1187, 1190, 1206, 1208, 1212, 1234, 1239, 1247, 1256, 1265, 1276, 1280, 1285, 1287, 1297, 1309, 1310, 1321, 1326, 1329, 1334, 1338, 1348, 1361, 1367, 1376, 1385, 1389, 1392, 1396, 1407, 1412, 1413, 1421, 1422, 1426, 1440, 1441, 1452, 1457, 1463, 1473, 1492, 1495, 1508, 1512, 1537, 1538, 1543, 1546, 1548, 1553, 1577, 1582, 1586, 1589, 1612, 1631, 1646, 1648, 1651, 1654, 1665, 1677, 1687, 1688, 1708, 1710, 1712, 1722, 1741, 1751, 1754, 1757, 1758, 1767, 1769, 1778, 1792, 1794, 1795, 1799, 1800, 1809, 1816, 1820, 1821, 1834, 1846, 1856, 1862, 1870, 1881, 1903, 1939, 1942, 1947, 1953, 1955, 1978, 1986, 1989, 2000, 2012, 2018, 2019, 2025, 2029, 2038]
[12, 14, 15, 20, 29, 36, 49, 50, 53, 59, 64, 68, 87, 91, 100, 106, 107, 118, 127, 130, 133, 135, 139, 144, 149, 155, 156, 158, 164, 167, 169, 170, 175, 179, 182, 183, 204, 205, 211, 213, 220, 222, 223, 225, 239, 251, 254, 259, 262, 264, 265, 267, 282, 292, 293, 302, 303, 304, 306, 310, 324, 332, 333, 334, 342, 343, 354, 355, 358, 359, 360, 366, 373, 375, 397, 400, 403, 408, 413, 422, 429, 431, 439, 443, 444, 450, 451, 458, 463, 464, 467, 480, 496, 508, 517, 518, 521, 526, 530, 537, 546, 551, 559, 560, 577, 583, 587, 590, 593, 595, 597, 608, 612, 616, 620, 621, 623, 626, 628, 644, 646, 653, 656, 659, 673, 678, 680, 690, 691, 693, 698, 700, 703, 709, 711, 712, 726, 741, 744, 751, 757, 761, 776, 778, 782, 786, 787, 806, 807, 809, 811, 815, 816, 826, 829, 836, 842, 849, 854, 857, 861, 863, 868, 872, 873, 875, 876, 883, 903, 906, 910, 919, 923, 924, 936, 938, 952, 956, 958, 959, 978, 984, 991, 999, 1004, 1008, 1010, 1011, 1014, 1018, 1024, 1025, 1029, 1030, 1032, 1037, 1041, 1042, 1044, 1065, 1069, 1076, 1078, 1081, 1093, 1094, 1096, 1099, 1104, 1108, 1109, 1111, 1115, 1122, 1123, 1128, 1134, 1142, 1147, 1153, 1154, 1165, 1176, 1179, 1180, 1188, 1191, 1196, 1198, 1203, 1209, 1218, 1219, 1224, 1226, 1229, 1231, 1235, 1240, 1243, 1254, 1261, 1262, 1263, 1264, 1269, 1273, 1284, 1286, 1289, 1295, 1296, 1300, 1307, 1316, 1317, 1327, 1333, 1341, 1347, 1349, 1352, 1357, 1365, 1368, 1370, 1375, 1377, 1383, 1395, 1398, 1411, 1414, 1419, 1423, 1424, 1425, 1433, 1439, 1445, 1448, 1449, 1460, 1461, 1467, 1470, 1471, 1474, 1484, 1488, 1499, 1500, 1518, 1523, 1527, 1528, 1534, 1554, 1558, 1564, 1568, 1569, 1590, 1592, 1602, 1605, 1616, 1618, 1636, 1638, 1639, 1644, 1666, 1671, 1673, 1674, 1675, 1685, 1696, 1697, 1704, 1706, 1709, 1720, 1725, 1726, 1730, 1744, 1745, 1746, 1763, 1764, 1776, 1779, 1781, 1786, 1804, 1811, 1813, 1814, 1815, 1818, 1819, 1824, 1826, 1830, 1832, 1833, 1840, 1843, 1844, 1847, 1848, 1851, 1852, 1853, 1855, 1858, 1861, 1863, 1864, 1867, 1873, 1874, 1880, 1882, 1889, 1891, 1896, 1899, 1911, 1912, 1921, 1926, 1927, 1937, 1940, 1950, 1961, 1964, 1966, 1967, 1968, 1972, 1973, 1979, 1980, 1981, 1988, 1990, 1998, 2003, 2013, 2014, 2022, 2032, 2036, 2041, 2054, 2067, 2068, 2075, 2094, 2101, 2103, 2105, 2111, 2129, 2131, 2134, 2149, 2150, 2160, 2163, 2164, 2169, 2172, 2177, 2178, 2179, 2185, 2209, 2210, 2212, 2213, 2214, 2221, 2223, 2224, 2228, 2231, 2232, 2236, 2237, 2239, 2245, 2249, 2253, 2270, 2271, 2277, 2278, 2279, 2292, 2293, 2294, 2301, 2314, 2315, 2319, 2320, 2325, 2329, 2330, 2332, 2343, 2345, 2347, 2349, 2351, 2357, 2360, 2370, 2381, 2382, 2389, 2404, 2407, 2411, 2429, 2436, 2440, 2442, 2451, 2463, 2473, 2481, 2490, 2498, 2510, 2513, 2523, 2534, 2545, 2557, 2564, 2566, 2568, 2574, 2575, 2583, 2585, 2586, 2593, 2596, 2600, 2601, 2613, 2620, 2633, 2639, 2648, 2649, 2655, 2657, 2659, 2685, 2690, 2701, 2702, 2703, 2709, 2723, 2728, 2730, 2731, 2733, 2736, 2744, 2752, 2754, 2757, 2766, 2768, 2774, 2779, 2785, 2796, 2800, 2803, 2808, 2817, 2827, 2839, 2859, 2861, 2863, 2865, 2881, 2883, 2886, 2899, 2902, 2906, 2913, 2916, 2932, 2935, 2954, 2959, 2969, 2970, 2971, 2974, 2975, 2990, 2993, 2997]
